102_-9_-1_0.1
102_-7_-1_0.1
101_-5.5_-0.5_0.1
200_-8_1_0.1_0
101_-3.5_-0.5_0.1
101_-1.5_-0.5_0.1
101_0.5_-0.5_0.1
102_3_0_0.1
102_6_0_0.1
102_9_0_0.1
102_12_1_0.1
102_15_1_0.1
102_18_1_0.1
102_21_2_0.1
102_24_2_0.1
102_27_2_0.1
102_30_3_0.1
102_33_3_0.1
102_36_3_0.1
102_39_-1_0.1
102_42_-1_0.1
102_45_-1_0.1
102_48_0_0.1
102_51_0_0.1
102_54_0_0.1
102_57_1_0.1
102_60_1_0.1
102_63_1_0.1
102_66_2_0.1
102_69_2_0.1
102_72_2_0.1
102_75_3_0.1
102_78_3_0.1
102_81_3_0.1
102_84_4_0.1
102_87_4_0.1
102_90_4_0.1
102_93_4_0.1
102_96_4_0.1
101_7.5_0.5_0.1
100_4.25_0.25_0.1
100_4.25_0.75_0.1
100_4.75_0.75_0.1
100_-4.75_-0.25_0.1
100_-4.25_-0.25_0.1
100_-2.75_-0.25_0.1
100_-2.25_-0.25_0.1
100_-0.75_-0.25_0.1
100_-0.25_-0.25_0.1
100_7.25_-0.25_0.1
100_13.25_1.75_0.1
100_13.75_1.75_0.1
100_13.75_1.25_0.1
100_16.25_1.75_0.1
100_16.75_1.75_0.1
101_22.5_2.5_0.1
100_25.25_2.75_0.1
100_25.75_2.75_0.1
101_31.5_3.5_0.1
101_34.5_3.5_0.1
201_33_5_0_29_5.5_0_37_5.5_0_1_3_3_1_5_1_301_6.25
100_40.25_-0.25_0.1
100_40.75_-0.25_0.1
100_43.25_-0.25_0.1
100_43.75_-0.25_0.1
101_49.5_0.5_0.1
100_52.25_0.75_0.1
100_52.75_0.75_0.1
100_58.25_1.75_0.1
100_58.75_1.75_0.1
100_58.75_1.25_0.1
100_61.25_1.25_0.1
100_61.25_1.75_0.1
100_61.75_1.75_0.1
100_67.25_2.75_0.1
100_67.75_2.75_0.1
100_67.25_2.25_0.1
101_70.5_2.5_0.1
100_79.25_3.75_0.1
100_79.75_3.75_0.1
100_79.75_3.25_0.1
101_76.5_3.5_0.1
101_85.5_4.5_0.1
101_88.5_4.5_0.1
101_91.5_4.5_0.1
101_94.5_4.5_0.1
101_97.5_4.5_0.1
100_85.75_3.75_0.1
100_88.25_3.75_0.1
100_91.75_3.75_0.1
100_94.25_3.75_0.1
200_39_1_0.1_0
201_90_6_0_83.31_6.5_0_94.5_6.5_0_3_5_3_1_5_1_301_8
200_96_6_0.1_1
100_-5.75_-1.25_0.1
100_0.75_-1.25_0.1
101_3.5_-1.5_0.1
100_5.25_-1.25_0.1
100_3.75_-2.25_0.1
100_9.75_-1.25_0.1
101_9_-1.5_0.1
100_12.75_-0.25_0.1
100_11.25_-0.25_0.1
101_14_-0.5_0.1
101_17.5_-0.5_0.1
100_15.75_-0.25_0.1
100_18.75_-0.25_0.1
100_17.75_-1.25_0.1
101_20.5_0.5_0.1
101_24_0.5_0.1
100_21.75_0.75_0.1
100_26.75_0.75_0.1
101_27.5_0.5_0.1
100_20.25_-0.25_0.1
101_30_1.5_0.1
101_36_1.5_0.1
101_33_1.5_0.1
100_30.75_1.75_0.1
100_35.25_1.75_0.1
100_29.75_0.75_0.1
100_36.25_0.75_0.1
100_31.75_2.75_0.1
100_34.25_2.75_0.1
100_-3.25_-1.25_0.1
100_-1.25_-1.25_0.1
101_41.5_-2.5_0.1
100_42.25_-2.25_0.1
100_44.75_-2.25_0.1
100_44.75_-2.75_0.1
100_45.75_-2.25_0.1
100_39.25_-2.25_0.1
101_39_-3_0.1
101_52_-1.5_0.1
100_51.75_-2.25_0.1
101_47.5_-1.5_0.1
100_48.75_-1.25_0.1
100_50.25_-1.25_0.1
100_53.25_-1.25_0.1
101_57.5_-0.5_0.1
101_62_-0.5_0.1
100_59.25_-0.25_0.1
100_60.25_-0.25_0.1
100_63.75_-0.25_0.1
100_56.75_-0.25_0.1
100_66.75_0.75_0.1
100_65.25_0.75_0.1
100_66.75_0.25_0.1
101_68.5_0.5_0.1
100_68.75_-0.25_0.1
100_69.75_0.75_0.1
100_71.25_0.75_0.1
101_72.5_0.5_0.1
100_80.25_1.75_0.1
100_80.25_1.25_0.1
100_81.25_1.75_0.1
101_79_1.5_0.1
101_76_1.5_0.1
100_78.75_0.75_0.1
100_77.25_1.75_0.1
100_74.75_1.75_0.1
101_84.5_2.5_0.1
101_87_2.5_0.1
101_93_2.5_0.1
101_95.5_2.5_0.1
101_90_2.5_0.1
100_84.75_1.75_0.1
100_84.75_1.25_0.1
100_95.25_1.75_0.1
100_95.25_1.25_0.1
100_87.25_1.75_0.1
100_92.75_1.75_0.1
103_37.625_2_0.1_0.5_6_2
102_-11_-1_0.1
102_-11_1_0.1
102_-11_3_0.1
102_99_5_0.1
102_99_7_0.1
102_99_9_0.1
