102_-9_-1.5_0.1
101_-7.5_-1_0.1
101_-6.5_-1_0.1
100_-5.75_-0.75_0.1
100_-8.75_-2.75_0.1
100_-8.75_-3.25_0.1
100_-8.25_-3.25_0.1
100_-8.25_-3.75_0.1
100_-6.75_-1.75_0.1
100_-6.75_-2.25_0.1
100_-7.25_-2.25_0.1
100_-6.25_-2.75_0.1
200_-9_0.5_0.1_0
102_-11_-1.5_0.1
102_-11_0.5_0.1
102_-11_2.5_0.1
109_-2.5_-1.5_0.1
102_-2.5_5_0.1
102_-0.5_4_0.1
102_1.5_3_0.1
104_2.75_2.25_0.1
104_3.25_2.25_0.1
104_3.75_2.25_0.1
104_4.25_2.25_0.1
104_4.75_2.25_0.1
104_5.25_2.25_0.1
104_5.75_2.25_0.1
104_6.25_2.25_0.1
102_7.5_2.5_0.1
102_9.5_1.5_0.1
108_11_1_0.1
102_11.5_-4.5_0.1
101_10_-4_0.1
101_13_-4_0.1
100_9.25_-3.75_0.1
100_9.75_-4.75_0.1
100_9.25_-5.25_0.1
100_11.75_-5.75_0.1
100_13.25_-4.75_0.1
102_11.5_9.5_0.1
102_9.5_9.5_0.1
103_7.125_7.5_0.1_0.5_7_4
102_13.5_9.5_0.1
102_15.5_9.5_0.1
200_15.5_7.5_0.1_0
105_17_9_0.1
105_18_9_0.1
105_20_9_0.1
105_19_9_0.1
100_20.75_8.75_0.1
100_21.25_8.75_0.1
100_21.75_8.75_0.1
100_22.25_8.75_0.1
