103_-9.875_0_0.1_0.5_4_1
100_-9.75_-2.25_0.1
100_-6.75_-2.25_0.1
100_-2.75_-1.75_0.1
100_0.25_-1.75_0.1
100_-6.25_-4.25_0.1
100_-3.25_-3.75_0.1
100_-0.75_-3.25_0.1
