200_-7_3_0.1
102_-9_1_0.1
102_-7_1_0.1
102_-5_1_0.1
101_-9.5_-0.5_0.1
101_-7_-0.5_0.1
101_-4.5_-0.5_0.1
100_-9.25_-1.25_0.1
100_-6.75_-1.25_0.1
100_-4.25_-1.25_0.1
101_-3.5_1.5_0.1
101_-2.5_1.5_0.1
101_-1.5_1.5_0.1
101_-2.5_0.5_0.1
101_-3_-0.5_0.1
100_-0.75_1.75_0.1
100_-0.25_1.75_0.1
100_0.25_1.75_0.1
100_0.25_1.25_0.1
100_0.25_0.75_0.1
