103_-5.875_1_0.1_0.5_4_1
109_-4.5_-1.5_0.1
109_-1_-1.5_0.1
105_2_1.5_0.1
105_3_-0.5_0.1
