109_-4_0_0.1
109_0.5_0_0.1
109_5.5_0_0.1
109_-6_4_0.1
100_2.25_2.75_0.1
100_0.25_2.75_0.1
100_-0.75_2.75_0.1
103_4.125_2.5_0.1_0.5_4_1
103_5.625_2.5_0.1_0.5_4_1
103_7.125_2.5_0.1_0.5_4_1
