100_-6.25_2.75_0.1
101_-8_2.5_0.1
104_-4.25_2.75_0.1
101_-9_2.5_0.1
100_-9.75_2.75_0.1
100_-9.75_2.25_0.1
100_-9.75_1.75_0.1
100_-9.75_1.25_0.1
100_-8.25_1.75_0.1
100_-5.75_2.75_0.1
100_-5.75_2.25_0.1
104_-2.75_2.75_0.1
102_15_3_0.1
102_17_3_0.1
101_18.5_3.5_0.1
100_14.25_1.75_0.1
100_14.25_1.25_0.1
100_14.25_0.75_0.1
100_16.25_1.75_0.1
100_16.25_1.25_0.1
101_18.5_2_0.1
100_18.25_1.25_0.1
100_16.75_1.25_0.1
100_16.75_0.75_0.1
100_19.25_3.75_0.1
200_-9_4_0.1_0
105_11_3.5_0.1
105_9_2.5_0.1
105_7_1_0.1
106_3.5_0.5_0.1
106_1.5_0.5_0.1
104_-1.25_2.75_0.1
