102_-3.5_-0.5_0.1
102_-9_-0.5_0.1
101_-7.5_0_0.1
101_-5_0_0.1
100_-6.75_0.25_0.1
100_-6.25_0.25_0.1
100_-5.75_0.25_0.1
100_-6.25_-0.25_0.1
100_-4.25_-1.75_0.1
100_-4.25_-2.25_0.1
100_-4.25_-2.75_0.1
100_-6.25_-0.75_0.1
100_-6.25_-1.25_0.1
100_-5.75_-1.25_0.1
100_-5.75_-1.75_0.1
100_-8.25_-1.75_0.1
100_-8.25_-2.25_0.1
100_-8.25_-2.75_0.1
100_-2.75_-1.75_0.1
100_-2.75_-2.25_0.1
100_-9.25_-1.75_0.1
100_-9.25_-2.25_0.1
100_-7.75_-0.75_0.1
100_-6.75_-0.25_0.1
100_-7.25_-1.25_0.1
100_-4.75_-3.25_0.1
100_-4.25_-3.25_0.1
100_-7.25_-0.75_0.1
101_-2_0_0.1
101_-1_0_0.1
101_0_0_0.1
100_0.75_0.25_0.1
100_1.25_0.25_0.1
100_1.75_0.25_0.1
100_2.25_0.25_0.1
102_6_-2_0.1
102_10_-2_0.1
102_14_-2_0.1
102_18_-2_0.1
101_8_-1.5_0.1
101_12_-1.5_0.1
101_16_-1.5_0.1
101_-0.5_-1_0.1
100_1.75_-0.25_0.1
100_2.25_-0.25_0.1
100_2.25_-0.75_0.1
100_0.25_-1.25_0.1
100_0.25_-1.75_0.1
100_-2.25_-1.25_0.1
100_7.25_-1.25_0.1
100_8.75_-1.25_0.1
100_8.25_-2.25_0.1
100_11.25_-1.25_0.1
100_12.75_-1.25_0.1
100_11.75_-2.25_0.1
100_15.25_-1.25_0.1
100_16.75_-1.25_0.1
100_16.25_-2.25_0.1
102_22_-1.5_0.1
102_26_-0.5_0.1
102_30_0.5_0.1
101_33.5_2_0.1
101_35.5_2_0.1
101_37.5_2_0.1
101_39.5_2_0.1
101_41.5_2_0.1
101_43.5_2_0.1
101_45.5_2_0.1
101_34_1_0.1
101_36_1_0.1
101_38_1_0.1
101_40_1_0.1
101_42_1_0.1
101_44_1_0.1
101_46_1_0.1
100_34.25_2.25_0.1
100_34.75_2.25_0.1
100_36.25_2.25_0.1
100_36.75_2.25_0.1
100_38.25_2.25_0.1
100_38.75_2.25_0.1
100_40.25_2.25_0.1
100_40.75_2.25_0.1
100_42.25_2.25_0.1
100_42.75_2.25_0.1
100_44.25_2.25_0.1
100_44.75_2.25_0.1
101_48.5_2.5_0.1
101_51.5_3.5_0.1
101_54.5_2.5_0.1
101_57.5_1.5_0.1
101_60.5_0.5_0.1
100_48.75_1.75_0.1
100_50.75_3.25_0.1
100_53.75_2.75_0.1
100_57.75_0.75_0.1
100_61.25_0.75_0.1
102_64.5_-2_0.1
101_66_-1.5_0.1
101_68_-1.5_0.1
101_70_-1.5_0.1
101_72_-1.5_0.1
101_74_-1.5_0.1
101_76_-1.5_0.1
102_77.5_-2_0.1
100_66.75_-1.25_0.1
100_67.25_-1.25_0.1
100_68.75_-1.25_0.1
100_69.25_-1.25_0.1
100_70.75_-1.25_0.1
100_71.25_-1.25_0.1
100_72.75_-1.25_0.1
100_73.25_-1.25_0.1
100_74.75_-1.25_0.1
100_75.25_-1.25_0.1
100_80.75_-1.25_0.1
100_81.25_-1.25_0.1
100_81.75_-1.25_0.1
100_82.25_-1.25_0.1
100_82.25_-1.75_0.1
100_81.25_-1.75_0.1
100_82.25_-2.25_0.1
100_84.75_-0.75_0.1
100_85.25_-0.75_0.1
100_85.75_-0.75_0.1
100_86.25_-0.75_0.1
100_85.75_-1.25_0.1
100_85.75_-1.75_0.1
100_85.75_-2.25_0.1
100_85.25_-1.25_0.1
100_85.25_-1.75_0.1
100_88.75_0.25_0.1
100_89.25_0.25_0.1
100_89.75_0.25_0.1
100_90.25_0.25_0.1
100_90.25_-0.25_0.1
100_90.25_-0.75_0.1
100_89.75_-0.25_0.1
100_89.25_-0.25_0.1
100_88.75_-0.25_0.1
100_89.25_-0.75_0.1
100_89.25_-1.25_0.1
100_92.75_1.25_0.1
100_93.25_1.25_0.1
100_93.75_1.25_0.1
100_94.25_1.25_0.1
100_94.75_1.25_0.1
100_95.25_1.25_0.1
100_95.75_1.25_0.1
100_96.75_1.25_0.1
100_96.25_1.25_0.1
100_97.25_1.25_0.1
100_97.75_1.25_0.1
101_93.5_0.5_0.1
101_95_0.5_0.1
101_97_0.5_0.1
100_94.25_0.75_0.1
100_93.75_-0.25_0.1
100_93.75_-0.75_0.1
100_94.25_-0.75_0.1
100_92.75_0.75_0.1
100_95.75_0.25_0.1
100_95.75_-0.25_0.1
100_96.75_-0.25_0.1
100_96.75_-0.75_0.1
100_96.75_-1.25_0.1
100_88.75_-1.25_0.1
100_86.25_-2.25_0.1
200_-8.75_1.75_0.1
200_48.25_4.25_0.1
