102_-9_-1.5_0.1
102_-5.5_-1.5_0.1
102_-2_-1.5_0.1
105_-7.5_-1.5_0.1
105_-4_-1.5_0.1
103_-9.875_1_0.1_0.5_4_1
200_-5.5_0.5_0.1_0
201_7_1_0_0.3099999_1.5_0_13.7_1.5_0_6_12_1_1_5_3_300_301_302_14.85
109_0_-1.5_0.1
